********************
********************
********************
********************
********************
********************
********************
********************
********************
*.******************
********************
 
********************
*..................*
*.******************
*..................*
******************.*
*........S.........*
*.******************
*..................*
******************.*
*..................*
********************
 
********************
******************.*
********************
********************
********************
********************
********************
********************
********************
********************
********************
 
********************
...................*
*********.**********
*********..........*
*********.**********
*.........**********
*********.**********
*********...........
*********.**********
*.........**********
********************
 
********************
******************.*
********************
********************
********************
********************
********************
********************
********************
********************
********************
 
********************
*................*.*
*.**************.*.*
*.*............*.*.*
*.*.**********.*.*.*
*.*.*..........*.*.*
*.*.************.*.*
*.*..............*.*
*.****************.*
*..................*
********************
 
********************
********************
********************
********************
********************
*****.**************
********************
********************
********************
********************
********************
 