********************
********************
********************
********************
********************
********************
********************
********************
********************
*.******************
********************
 
********************
*..................*
*.******************
*..................*
******************.*
*........S.........*
*.******************
*..................*
******************.*
*..................*
********************
 
********************
********************
********************
******************.*
********************
********************
********************
********************
********************
********************
********************
 
********************
*.........*******.**
**..************..**
***..**********..*.*
****..********..****
*****..******..*****
******..****..******
*******..**..*******
*********...********
*.******************
********************
 
********************
*****************.**
********************
******************.*
********************
********************
********************
********************
********************
********************
********************
 
********************
*.................**
*.**************.***
*.*............*.*.*
*.*.**********.*.*.*
*.*.*..........*.*.*
*.*.************.*.*
*.*..............*.*
*.****************.*
*..................*
********************
 
********************
********************
********************
********************
********************
*****.**************
********************
********************
********************
********************
********************
 